F     100,100,100
C     200,200,200

NO    ./path/to/north_texture.xpm
SO    ./path/to/south_texture.xpm
WE    ./path/to/west_texture.xpm
EA    ./path/to/east_texture.xpm

11111111111111111111
10000000000000000001
10111101111101111101
10000101000001010001
10000100000000010001
10000101000001010001
10111101111101111101
10000000000000000001
100000000N0000000001
11111111111111111111

